"filename", "language", "Markdown", "YAML", "comment", "blank", "total"
"/Users/longhui/code/study/github/front3-1/2020-02-18.md", "Markdown", 39, 0, 3, 0, 42
"/Users/longhui/code/study/github/front3-1/2020-02-19.md", "Markdown", 35, 0, 0, 1, 36
"/Users/longhui/code/study/github/front3-1/2020-02-20.md", "Markdown", 25, 0, 0, 1, 26
"/Users/longhui/code/study/github/front3-1/2020-02-21.md", "Markdown", 37, 0, 0, 0, 37
"/Users/longhui/code/study/github/front3-1/2020-02-22.md", "Markdown", 22, 0, 0, 0, 22
"/Users/longhui/code/study/github/front3-1/2020-02-23.md", "Markdown", 19, 0, 0, 2, 21
"/Users/longhui/code/study/github/front3-1/2020-02-24.md", "Markdown", 16, 0, 0, 2, 18
"/Users/longhui/code/study/github/front3-1/2020-02-25.md", "Markdown", 11, 0, 0, 0, 11
"/Users/longhui/code/study/github/front3-1/2020-02-26.md", "Markdown", 16, 0, 0, 1, 17
"/Users/longhui/code/study/github/front3-1/2020-02-27.md", "Markdown", 16, 0, 0, 6, 22
"/Users/longhui/code/study/github/front3-1/2020-02-28.md", "Markdown", 14, 0, 0, 3, 17
"/Users/longhui/code/study/github/front3-1/2020-02-29.md", "Markdown", 69, 0, 0, 0, 69
"/Users/longhui/code/study/github/front3-1/2020-03-01.md", "Markdown", 48, 0, 0, 1, 49
"/Users/longhui/code/study/github/front3-1/2020-03-02.md", "Markdown", 25, 0, 0, 2, 27
"/Users/longhui/code/study/github/front3-1/2020-03-03.md", "Markdown", 29, 0, 0, 2, 31
"/Users/longhui/code/study/github/front3-1/2020-03-04.md", "Markdown", 27, 0, 0, 0, 27
"/Users/longhui/code/study/github/front3-1/2020-03-05.md", "Markdown", 27, 0, 0, 0, 27
"/Users/longhui/code/study/github/front3-1/2020-03-06.md", "Markdown", 24, 0, 0, 0, 24
"/Users/longhui/code/study/github/front3-1/2020-03-07.md", "Markdown", 27, 0, 0, 0, 27
"/Users/longhui/code/study/github/front3-1/2020-03-08.md", "Markdown", 20, 0, 0, 1, 21
"/Users/longhui/code/study/github/front3-1/2020-03-09.md", "Markdown", 27, 0, 0, 2, 29
"/Users/longhui/code/study/github/front3-1/2020-03-10.md", "Markdown", 82, 0, 0, 0, 82
"/Users/longhui/code/study/github/front3-1/2020-03-11.md", "Markdown", 37, 0, 0, 1, 38
"/Users/longhui/code/study/github/front3-1/2020-03-12.md", "Markdown", 20, 0, 0, 1, 21
"/Users/longhui/code/study/github/front3-1/2020-03-13.md", "Markdown", 22, 0, 0, 1, 23
"/Users/longhui/code/study/github/front3-1/2020-03-14.md", "Markdown", 19, 0, 0, 0, 19
"/Users/longhui/code/study/github/front3-1/2020-03-15.md", "Markdown", 28, 0, 0, 0, 28
"/Users/longhui/code/study/github/front3-1/2020-03-16.md", "Markdown", 22, 0, 0, 0, 22
"/Users/longhui/code/study/github/front3-1/2020-03-17.md", "Markdown", 22, 0, 0, 0, 22
"/Users/longhui/code/study/github/front3-1/2020-03-18.md", "Markdown", 23, 0, 0, 0, 23
"/Users/longhui/code/study/github/front3-1/2020-03-19.md", "Markdown", 18, 0, 0, 1, 19
"/Users/longhui/code/study/github/front3-1/2020-03-20.md", "Markdown", 54, 0, 0, 1, 55
"/Users/longhui/code/study/github/front3-1/2020-03-21.md", "Markdown", 10, 0, 0, 0, 10
"/Users/longhui/code/study/github/front3-1/2020-03-22.md", "Markdown", 20, 0, 0, 0, 20
"/Users/longhui/code/study/github/front3-1/2020-03-23.md", "Markdown", 12, 0, 0, 0, 12
"/Users/longhui/code/study/github/front3-1/2020-03-24.md", "Markdown", 20, 0, 0, 1, 21
"/Users/longhui/code/study/github/front3-1/2020-03-25.md", "Markdown", 21, 0, 0, 0, 21
"/Users/longhui/code/study/github/front3-1/2020-03-26.md", "Markdown", 15, 0, 0, 0, 15
"/Users/longhui/code/study/github/front3-1/2020-03-27.md", "Markdown", 31, 0, 0, 0, 31
"/Users/longhui/code/study/github/front3-1/2020-03-28.md", "Markdown", 19, 0, 0, 0, 19
"/Users/longhui/code/study/github/front3-1/2020-03-29.md", "Markdown", 19, 0, 0, 1, 20
"/Users/longhui/code/study/github/front3-1/2020-03-30.md", "Markdown", 16, 0, 0, 0, 16
"/Users/longhui/code/study/github/front3-1/2020-03-31.md", "Markdown", 12, 0, 0, 0, 12
"/Users/longhui/code/study/github/front3-1/2020-04-01.md", "Markdown", 12, 0, 0, 0, 12
"/Users/longhui/code/study/github/front3-1/2020-04-02.md", "Markdown", 61, 0, 0, 0, 61
"/Users/longhui/code/study/github/front3-1/2020-04-03.md", "Markdown", 12, 0, 0, 0, 12
"/Users/longhui/code/study/github/front3-1/2020-04-04.md", "Markdown", 23, 0, 0, 0, 23
"/Users/longhui/code/study/github/front3-1/2020-04-05.md", "Markdown", 44, 0, 0, 0, 44
"/Users/longhui/code/study/github/front3-1/2020-04-06.md", "Markdown", 56, 0, 0, 1, 57
"/Users/longhui/code/study/github/front3-1/2020-04-07.md", "Markdown", 11, 0, 0, 0, 11
"/Users/longhui/code/study/github/front3-1/2020-04-08.md", "Markdown", 13, 0, 0, 0, 13
"/Users/longhui/code/study/github/front3-1/2020-04-09.md", "Markdown", 38, 0, 0, 0, 38
"/Users/longhui/code/study/github/front3-1/2020-04-10.md", "Markdown", 12, 0, 0, 0, 12
"/Users/longhui/code/study/github/front3-1/2020-04-11.md", "Markdown", 24, 0, 0, 0, 24
"/Users/longhui/code/study/github/front3-1/2020-04-12.md", "Markdown", 20, 0, 0, 0, 20
"/Users/longhui/code/study/github/front3-1/2020-04-13.md", "Markdown", 10, 0, 0, 0, 10
"/Users/longhui/code/study/github/front3-1/2020-04-14.md", "Markdown", 11, 0, 0, 0, 11
"/Users/longhui/code/study/github/front3-1/2020-04-15.md", "Markdown", 27, 0, 0, 0, 27
"/Users/longhui/code/study/github/front3-1/2020-04-16.md", "Markdown", 44, 0, 0, 2, 46
"/Users/longhui/code/study/github/front3-1/2020-04-17.md", "Markdown", 11, 0, 0, 0, 11
"/Users/longhui/code/study/github/front3-1/2020-04-18.md", "Markdown", 38, 0, 0, 0, 38
"/Users/longhui/code/study/github/front3-1/2020-04-19.md", "Markdown", 9, 0, 0, 0, 9
"/Users/longhui/code/study/github/front3-1/2020-04-20.md", "Markdown", 17, 0, 0, 0, 17
"/Users/longhui/code/study/github/front3-1/2020-04-21.md", "Markdown", 18, 0, 0, 0, 18
"/Users/longhui/code/study/github/front3-1/2020-04-22.md", "Markdown", 38, 0, 0, 0, 38
"/Users/longhui/code/study/github/front3-1/2020-04-23.md", "Markdown", 9, 0, 0, 0, 9
"/Users/longhui/code/study/github/front3-1/2020-04-24.md", "Markdown", 11, 0, 0, 0, 11
"/Users/longhui/code/study/github/front3-1/2020-04-25.md", "Markdown", 11, 0, 0, 0, 11
"/Users/longhui/code/study/github/front3-1/2020-04-26.md", "Markdown", 9, 0, 0, 0, 9
"/Users/longhui/code/study/github/front3-1/2020-04-27.md", "Markdown", 9, 0, 0, 0, 9
"/Users/longhui/code/study/github/front3-1/2020-04-28.md", "Markdown", 10, 0, 0, 0, 10
"/Users/longhui/code/study/github/front3-1/2020-04-29.md", "Markdown", 14, 0, 0, 1, 15
"/Users/longhui/code/study/github/front3-1/2020-04-30.md", "Markdown", 12, 0, 0, 0, 12
"/Users/longhui/code/study/github/front3-1/2020-05-01.md", "Markdown", 14, 0, 0, 0, 14
"/Users/longhui/code/study/github/front3-1/2020-05-02.md", "Markdown", 10, 0, 0, 0, 10
"/Users/longhui/code/study/github/front3-1/2020-05-03.md", "Markdown", 11, 0, 0, 0, 11
"/Users/longhui/code/study/github/front3-1/2020-05-04.md", "Markdown", 15, 0, 0, 0, 15
"/Users/longhui/code/study/github/front3-1/2020-05-05.md", "Markdown", 9, 0, 0, 0, 9
"/Users/longhui/code/study/github/front3-1/2020-05-06.md", "Markdown", 9, 0, 0, 0, 9
"/Users/longhui/code/study/github/front3-1/2020-05-07.md", "Markdown", 9, 0, 0, 0, 9
"/Users/longhui/code/study/github/front3-1/2020-05-08.md", "Markdown", 10, 0, 0, 1, 11
"/Users/longhui/code/study/github/front3-1/2020-05-09.md", "Markdown", 10, 0, 0, 1, 11
"/Users/longhui/code/study/github/front3-1/2020-05-10.md", "Markdown", 10, 0, 0, 0, 10
"/Users/longhui/code/study/github/front3-1/2020-05-11.md", "Markdown", 14, 0, 0, 0, 14
"/Users/longhui/code/study/github/front3-1/2020-05-12.md", "Markdown", 10, 0, 0, 0, 10
"/Users/longhui/code/study/github/front3-1/2020-05-13.md", "Markdown", 11, 0, 0, 0, 11
"/Users/longhui/code/study/github/front3-1/2020-05-14.md", "Markdown", 10, 0, 0, 0, 10
"/Users/longhui/code/study/github/front3-1/2020-05-15.md", "Markdown", 16, 0, 0, 0, 16
"/Users/longhui/code/study/github/front3-1/2020-05-16.md", "Markdown", 13, 0, 0, 0, 13
"/Users/longhui/code/study/github/front3-1/2020-05-17.md", "Markdown", 9, 0, 0, 0, 9
"/Users/longhui/code/study/github/front3-1/2020-05-18.md", "Markdown", 10, 0, 0, 0, 10
"/Users/longhui/code/study/github/front3-1/2020-05-19.md", "Markdown", 10, 0, 0, 1, 11
"/Users/longhui/code/study/github/front3-1/2020-05-20.md", "Markdown", 10, 0, 0, 0, 10
"/Users/longhui/code/study/github/front3-1/2020-05-21.md", "Markdown", 9, 0, 0, 0, 9
"/Users/longhui/code/study/github/front3-1/2020-05-22.md", "Markdown", 24, 0, 0, 1, 25
"/Users/longhui/code/study/github/front3-1/2020-05-23.md", "Markdown", 10, 0, 0, 0, 10
"/Users/longhui/code/study/github/front3-1/2020-05-24.md", "Markdown", 11, 0, 0, 0, 11
"/Users/longhui/code/study/github/front3-1/2020-05-25.md", "Markdown", 5, 0, 0, 0, 5
"/Users/longhui/code/study/github/front3-1/2020-05-26.md", "Markdown", 11, 0, 0, 0, 11
"/Users/longhui/code/study/github/front3-1/2020-05-27.md", "Markdown", 17, 0, 0, 0, 17
"/Users/longhui/code/study/github/front3-1/2020-05-28.md", "Markdown", 20, 0, 0, 0, 20
"/Users/longhui/code/study/github/front3-1/2020-05-29.md", "Markdown", 11, 0, 0, 0, 11
"/Users/longhui/code/study/github/front3-1/2020-05-30.md", "Markdown", 14, 0, 0, 0, 14
"/Users/longhui/code/study/github/front3-1/2020-05-31.md", "Markdown", 9, 0, 0, 0, 9
"/Users/longhui/code/study/github/front3-1/2020-06-01.md", "Markdown", 10, 0, 0, 0, 10
"/Users/longhui/code/study/github/front3-1/2020-06-02.md", "Markdown", 12, 0, 0, 0, 12
"/Users/longhui/code/study/github/front3-1/2020-06-03.md", "Markdown", 10, 0, 0, 0, 10
"/Users/longhui/code/study/github/front3-1/2020-06-04.md", "Markdown", 12, 0, 0, 0, 12
"/Users/longhui/code/study/github/front3-1/2020-06-05.md", "Markdown", 9, 0, 0, 0, 9
"/Users/longhui/code/study/github/front3-1/2020-06-06.md", "Markdown", 9, 0, 0, 0, 9
"/Users/longhui/code/study/github/front3-1/2020-06-07.md", "Markdown", 23, 0, 0, 0, 23
"/Users/longhui/code/study/github/front3-1/2020-06-08.md", "Markdown", 10, 0, 0, 0, 10
"/Users/longhui/code/study/github/front3-1/2020-06-09.md", "Markdown", 10, 0, 0, 0, 10
"/Users/longhui/code/study/github/front3-1/2020-06-10.md", "Markdown", 10, 0, 0, 0, 10
"/Users/longhui/code/study/github/front3-1/2020-06-11.md", "Markdown", 9, 0, 0, 0, 9
"/Users/longhui/code/study/github/front3-1/2020-06-12.md", "Markdown", 9, 0, 0, 0, 9
"/Users/longhui/code/study/github/front3-1/2020-06-13.md", "Markdown", 9, 0, 0, 0, 9
"/Users/longhui/code/study/github/front3-1/2020-06-14.md", "Markdown", 12, 0, 0, 0, 12
"/Users/longhui/code/study/github/front3-1/2020-06-15.md", "Markdown", 30, 0, 0, 1, 31
"/Users/longhui/code/study/github/front3-1/2020-06-16.md", "Markdown", 11, 0, 0, 0, 11
"/Users/longhui/code/study/github/front3-1/2020-06-17.md", "Markdown", 18, 0, 0, 0, 18
"/Users/longhui/code/study/github/front3-1/2020-06-18.md", "Markdown", 9, 0, 0, 0, 9
"/Users/longhui/code/study/github/front3-1/2020-06-19.md", "Markdown", 9, 0, 0, 0, 9
"/Users/longhui/code/study/github/front3-1/2020-06-20.md", "Markdown", 15, 0, 0, 0, 15
"/Users/longhui/code/study/github/front3-1/2020-06-21.md", "Markdown", 11, 0, 0, 1, 12
"/Users/longhui/code/study/github/front3-1/2020-06-22.md", "Markdown", 20, 0, 0, 0, 20
"/Users/longhui/code/study/github/front3-1/2020-06-23.md", "Markdown", 13, 0, 0, 0, 13
"/Users/longhui/code/study/github/front3-1/2020-06-24.md", "Markdown", 11, 0, 0, 0, 11
"/Users/longhui/code/study/github/front3-1/2020-06-25.md", "Markdown", 9, 0, 0, 0, 9
"/Users/longhui/code/study/github/front3-1/2020-06-26.md", "Markdown", 9, 0, 0, 0, 9
"/Users/longhui/code/study/github/front3-1/2020-06-27.md", "Markdown", 12, 0, 0, 0, 12
"/Users/longhui/code/study/github/front3-1/2020-06-28.md", "Markdown", 11, 0, 0, 0, 11
"/Users/longhui/code/study/github/front3-1/2020-06-29.md", "Markdown", 11, 0, 0, 0, 11
"/Users/longhui/code/study/github/front3-1/2020-06-30.md", "Markdown", 11, 0, 0, 0, 11
"/Users/longhui/code/study/github/front3-1/2020-07-01.md", "Markdown", 8, 0, 0, 0, 8
"/Users/longhui/code/study/github/front3-1/2020-07-02.md", "Markdown", 8, 0, 0, 0, 8
"/Users/longhui/code/study/github/front3-1/2020-07-03.md", "Markdown", 10, 0, 0, 0, 10
"/Users/longhui/code/study/github/front3-1/2020-07-04.md", "Markdown", 29, 0, 0, 1, 30
"/Users/longhui/code/study/github/front3-1/2020-07-05.md", "Markdown", 9, 0, 0, 0, 9
"/Users/longhui/code/study/github/front3-1/2020-07-06.md", "Markdown", 9, 0, 0, 0, 9
"/Users/longhui/code/study/github/front3-1/2020-07-07.md", "Markdown", 12, 0, 0, 0, 12
"/Users/longhui/code/study/github/front3-1/2020-07-08.md", "Markdown", 12, 0, 0, 0, 12
"/Users/longhui/code/study/github/front3-1/2020-07-09.md", "Markdown", 30, 0, 0, 5, 35
"/Users/longhui/code/study/github/front3-1/2020-07-10.md", "Markdown", 9, 0, 0, 0, 9
"/Users/longhui/code/study/github/front3-1/2020-07-11.md", "Markdown", 12, 0, 0, 0, 12
"/Users/longhui/code/study/github/front3-1/2020-07-12.md", "Markdown", 40, 0, 0, 2, 42
"/Users/longhui/code/study/github/front3-1/2020-07-13.md", "Markdown", 14, 0, 0, 0, 14
"/Users/longhui/code/study/github/front3-1/2020-07-14.md", "Markdown", 10, 0, 0, 0, 10
"/Users/longhui/code/study/github/front3-1/2020-07-15.md", "Markdown", 14, 0, 0, 0, 14
"/Users/longhui/code/study/github/front3-1/2020-07-16.md", "Markdown", 9, 0, 0, 0, 9
"/Users/longhui/code/study/github/front3-1/2020-07-17.md", "Markdown", 9, 0, 0, 0, 9
"/Users/longhui/code/study/github/front3-1/2020-07-18.md", "Markdown", 12, 0, 0, 0, 12
"/Users/longhui/code/study/github/front3-1/2020-07-19.md", "Markdown", 14, 0, 0, 0, 14
"/Users/longhui/code/study/github/front3-1/2020-07-20.md", "Markdown", 10, 0, 0, 0, 10
"/Users/longhui/code/study/github/front3-1/2020-07-21.md", "Markdown", 9, 0, 0, 0, 9
"/Users/longhui/code/study/github/front3-1/2020-07-22.md", "Markdown", 10, 0, 0, 0, 10
"/Users/longhui/code/study/github/front3-1/2020-07-23.md", "Markdown", 9, 0, 0, 0, 9
"/Users/longhui/code/study/github/front3-1/2020-07-24.md", "Markdown", 9, 0, 0, 0, 9
"/Users/longhui/code/study/github/front3-1/2020-07-25.md", "Markdown", 9, 0, 0, 0, 9
"/Users/longhui/code/study/github/front3-1/2020-07-26.md", "Markdown", 11, 0, 0, 0, 11
"/Users/longhui/code/study/github/front3-1/2020-07-27.md", "Markdown", 9, 0, 0, 0, 9
"/Users/longhui/code/study/github/front3-1/2020-07-28.md", "Markdown", 9, 0, 0, 0, 9
"/Users/longhui/code/study/github/front3-1/2020-07-29.md", "Markdown", 9, 0, 0, 0, 9
"/Users/longhui/code/study/github/front3-1/2020-07-30.md", "Markdown", 9, 0, 0, 0, 9
"/Users/longhui/code/study/github/front3-1/2020-07-31.md", "Markdown", 10, 0, 0, 0, 10
"/Users/longhui/code/study/github/front3-1/2020-08-01.md", "Markdown", 6, 0, 0, 0, 6
"/Users/longhui/code/study/github/front3-1/2020-08-02.md", "Markdown", 9, 0, 0, 0, 9
"/Users/longhui/code/study/github/front3-1/2020-08-03.md", "Markdown", 9, 0, 0, 0, 9
"/Users/longhui/code/study/github/front3-1/2020-08-04.md", "Markdown", 10, 0, 0, 0, 10
"/Users/longhui/code/study/github/front3-1/2020-08-05.md", "Markdown", 9, 0, 0, 1, 10
"/Users/longhui/code/study/github/front3-1/2020-08-06.md", "Markdown", 9, 0, 0, 0, 9
"/Users/longhui/code/study/github/front3-1/2020-08-07.md", "Markdown", 8, 0, 0, 0, 8
"/Users/longhui/code/study/github/front3-1/2020-08-08.md", "Markdown", 9, 0, 0, 0, 9
"/Users/longhui/code/study/github/front3-1/2020-08-09.md", "Markdown", 10, 0, 0, 0, 10
"/Users/longhui/code/study/github/front3-1/2020-08-10.md", "Markdown", 10, 0, 0, 0, 10
"/Users/longhui/code/study/github/front3-1/2020-08-11.md", "Markdown", 11, 0, 0, 0, 11
"/Users/longhui/code/study/github/front3-1/2020-08-12.md", "Markdown", 9, 0, 0, 0, 9
"/Users/longhui/code/study/github/front3-1/2020-08-13.md", "Markdown", 10, 0, 0, 0, 10
"/Users/longhui/code/study/github/front3-1/2020-08-14.md", "Markdown", 12, 0, 0, 0, 12
"/Users/longhui/code/study/github/front3-1/2020-08-15.md", "Markdown", 10, 0, 0, 0, 10
"/Users/longhui/code/study/github/front3-1/2020-08-16.md", "Markdown", 13, 0, 0, 0, 13
"/Users/longhui/code/study/github/front3-1/2020-08-17.md", "Markdown", 10, 0, 0, 0, 10
"/Users/longhui/code/study/github/front3-1/2020-08-18.md", "Markdown", 9, 0, 0, 0, 9
"/Users/longhui/code/study/github/front3-1/2020-08-19.md", "Markdown", 11, 0, 0, 0, 11
"/Users/longhui/code/study/github/front3-1/2020-08-20.md", "Markdown", 30, 0, 0, 2, 32
"/Users/longhui/code/study/github/front3-1/2020-08-21.md", "Markdown", 12, 0, 0, 0, 12
"/Users/longhui/code/study/github/front3-1/2020-08-22.md", "Markdown", 11, 0, 0, 0, 11
"/Users/longhui/code/study/github/front3-1/2020-08-23.md", "Markdown", 10, 0, 0, 0, 10
"/Users/longhui/code/study/github/front3-1/2020-08-24.md", "Markdown", 9, 0, 0, 0, 9
"/Users/longhui/code/study/github/front3-1/2020-08-25.md", "Markdown", 15, 0, 0, 0, 15
"/Users/longhui/code/study/github/front3-1/2020-08-26.md", "Markdown", 9, 0, 0, 0, 9
"/Users/longhui/code/study/github/front3-1/2020-08-27.md", "Markdown", 10, 0, 0, 0, 10
"/Users/longhui/code/study/github/front3-1/2020-08-28.md", "Markdown", 13, 0, 0, 0, 13
"/Users/longhui/code/study/github/front3-1/2020-08-29.md", "Markdown", 9, 0, 0, 0, 9
"/Users/longhui/code/study/github/front3-1/2020-08-30.md", "Markdown", 8, 0, 0, 0, 8
"/Users/longhui/code/study/github/front3-1/2020-08-31.md", "Markdown", 8, 0, 0, 0, 8
"/Users/longhui/code/study/github/front3-1/2020-09-01.md", "Markdown", 11, 0, 0, 0, 11
"/Users/longhui/code/study/github/front3-1/2020-09-02.md", "Markdown", 9, 0, 0, 0, 9
"/Users/longhui/code/study/github/front3-1/2020-09-03.md", "Markdown", 9, 0, 0, 0, 9
"/Users/longhui/code/study/github/front3-1/2020-09-04.md", "Markdown", 5, 0, 0, 0, 5
"/Users/longhui/code/study/github/front3-1/2020-09-05.md", "Markdown", 9, 0, 0, 0, 9
"/Users/longhui/code/study/github/front3-1/2020-09-06.md", "Markdown", 11, 0, 0, 0, 11
"/Users/longhui/code/study/github/front3-1/2020-09-07.md", "Markdown", 8, 0, 0, 0, 8
"/Users/longhui/code/study/github/front3-1/2020-09-08.md", "Markdown", 7, 0, 0, 0, 7
"/Users/longhui/code/study/github/front3-1/2020-09-09.md", "Markdown", 22, 0, 0, 0, 22
"/Users/longhui/code/study/github/front3-1/2020-09-10.md", "Markdown", 8, 0, 0, 0, 8
"/Users/longhui/code/study/github/front3-1/2020-09-11.md", "Markdown", 11, 0, 0, 0, 11
"/Users/longhui/code/study/github/front3-1/2020-09-12.md", "Markdown", 8, 0, 0, 0, 8
"/Users/longhui/code/study/github/front3-1/2020-09-13.md", "Markdown", 10, 0, 0, 0, 10
"/Users/longhui/code/study/github/front3-1/2020-09-14.md", "Markdown", 12, 0, 0, 0, 12
"/Users/longhui/code/study/github/front3-1/2020-09-15.md", "Markdown", 12, 0, 0, 0, 12
"/Users/longhui/code/study/github/front3-1/2020-09-16.md", "Markdown", 14, 0, 0, 0, 14
"/Users/longhui/code/study/github/front3-1/2020-09-17.md", "Markdown", 9, 0, 0, 0, 9
"/Users/longhui/code/study/github/front3-1/2020-09-18.md", "Markdown", 28, 0, 0, 1, 29
"/Users/longhui/code/study/github/front3-1/2020-09-19.md", "Markdown", 8, 0, 0, 0, 8
"/Users/longhui/code/study/github/front3-1/2020-09-20.md", "Markdown", 6, 0, 0, 0, 6
"/Users/longhui/code/study/github/front3-1/2020-09-21.md", "Markdown", 12, 0, 0, 0, 12
"/Users/longhui/code/study/github/front3-1/2020-09-22.md", "Markdown", 9, 0, 0, 0, 9
"/Users/longhui/code/study/github/front3-1/2020-09-23.md", "Markdown", 48, 0, 0, 0, 48
"/Users/longhui/code/study/github/front3-1/2020-09-24.md", "Markdown", 14, 0, 0, 0, 14
"/Users/longhui/code/study/github/front3-1/2020-09-25.md", "Markdown", 16, 0, 0, 0, 16
"/Users/longhui/code/study/github/front3-1/2020-09-26.md", "Markdown", 21, 0, 0, 0, 21
"/Users/longhui/code/study/github/front3-1/2020-09-27.md", "Markdown", 8, 0, 0, 0, 8
"/Users/longhui/code/study/github/front3-1/2020-09-28.md", "Markdown", 25, 0, 0, 0, 25
"/Users/longhui/code/study/github/front3-1/2020-09-29.md", "Markdown", 12, 0, 0, 0, 12
"/Users/longhui/code/study/github/front3-1/2020-09-30.md", "Markdown", 11, 0, 0, 0, 11
"/Users/longhui/code/study/github/front3-1/2020-10-01.md", "Markdown", 6, 0, 0, 0, 6
"/Users/longhui/code/study/github/front3-1/2020-10-02.md", "Markdown", 22, 0, 0, 0, 22
"/Users/longhui/code/study/github/front3-1/2020-10-03.md", "Markdown", 12, 0, 0, 0, 12
"/Users/longhui/code/study/github/front3-1/2020-10-04.md", "Markdown", 11, 0, 0, 0, 11
"/Users/longhui/code/study/github/front3-1/2020-10-05.md", "Markdown", 7, 0, 0, 0, 7
"/Users/longhui/code/study/github/front3-1/2020-10-06.md", "Markdown", 9, 0, 0, 0, 9
"/Users/longhui/code/study/github/front3-1/2020-10-07.md", "Markdown", 11, 0, 0, 0, 11
"/Users/longhui/code/study/github/front3-1/2020-10-08.md", "Markdown", 7, 0, 0, 0, 7
"/Users/longhui/code/study/github/front3-1/2020-10-09.md", "Markdown", 11, 0, 0, 0, 11
"/Users/longhui/code/study/github/front3-1/2020-10-10.md", "Markdown", 10, 0, 0, 0, 10
"/Users/longhui/code/study/github/front3-1/2020-10-11.md", "Markdown", 8, 0, 0, 0, 8
"/Users/longhui/code/study/github/front3-1/2020-10-12.md", "Markdown", 9, 0, 0, 0, 9
"/Users/longhui/code/study/github/front3-1/2020-10-13.md", "Markdown", 9, 0, 0, 0, 9
"/Users/longhui/code/study/github/front3-1/2020-10-14.md", "Markdown", 8, 0, 0, 0, 8
"/Users/longhui/code/study/github/front3-1/2020-10-15.md", "Markdown", 9, 0, 0, 0, 9
"/Users/longhui/code/study/github/front3-1/2020-10-16.md", "Markdown", 9, 0, 0, 0, 9
"/Users/longhui/code/study/github/front3-1/2020-10-17.md", "Markdown", 5, 0, 0, 0, 5
"/Users/longhui/code/study/github/front3-1/2020-10-18.md", "Markdown", 6, 0, 0, 0, 6
"/Users/longhui/code/study/github/front3-1/2020-10-19.md", "Markdown", 8, 0, 0, 0, 8
"/Users/longhui/code/study/github/front3-1/2020-10-20.md", "Markdown", 5, 0, 0, 0, 5
"/Users/longhui/code/study/github/front3-1/2020-10-21.md", "Markdown", 5, 0, 0, 0, 5
"/Users/longhui/code/study/github/front3-1/2020-10-22.md", "Markdown", 8, 0, 0, 0, 8
"/Users/longhui/code/study/github/front3-1/2020-10-23.md", "Markdown", 64, 0, 0, 1, 65
"/Users/longhui/code/study/github/front3-1/2020-10-24.md", "Markdown", 10, 0, 0, 0, 10
"/Users/longhui/code/study/github/front3-1/2020-10-25.md", "Markdown", 9, 0, 0, 0, 9
"/Users/longhui/code/study/github/front3-1/2020-10-26.md", "Markdown", 22, 0, 0, 1, 23
"/Users/longhui/code/study/github/front3-1/2020-10-27.md", "Markdown", 10, 0, 0, 0, 10
"/Users/longhui/code/study/github/front3-1/2020-10-28.md", "Markdown", 32, 0, 0, 3, 35
"/Users/longhui/code/study/github/front3-1/2020-10-29.md", "Markdown", 12, 0, 0, 0, 12
"/Users/longhui/code/study/github/front3-1/2020-10-30.md", "Markdown", 9, 0, 0, 0, 9
"/Users/longhui/code/study/github/front3-1/2020-10-31.md", "Markdown", 9, 0, 0, 0, 9
"/Users/longhui/code/study/github/front3-1/2020-11-01.md", "Markdown", 11, 0, 0, 0, 11
"/Users/longhui/code/study/github/front3-1/2020-11-02.md", "Markdown", 6, 0, 0, 0, 6
"/Users/longhui/code/study/github/front3-1/2020-11-03.md", "Markdown", 9, 0, 0, 0, 9
"/Users/longhui/code/study/github/front3-1/2020-11-04.md", "Markdown", 9, 0, 0, 0, 9
"/Users/longhui/code/study/github/front3-1/2020-11-05.md", "Markdown", 9, 0, 0, 0, 9
"/Users/longhui/code/study/github/front3-1/2020-11-06.md", "Markdown", 9, 0, 0, 0, 9
"/Users/longhui/code/study/github/front3-1/2020-11-07.md", "Markdown", 9, 0, 0, 0, 9
"/Users/longhui/code/study/github/front3-1/2020-11-08.md", "Markdown", 9, 0, 0, 0, 9
"/Users/longhui/code/study/github/front3-1/2020-11-09.md", "Markdown", 9, 0, 0, 0, 9
"/Users/longhui/code/study/github/front3-1/2020-11-10.md", "Markdown", 8, 0, 0, 0, 8
"/Users/longhui/code/study/github/front3-1/2020-11-11.md", "Markdown", 7, 0, 0, 0, 7
"/Users/longhui/code/study/github/front3-1/2020-11-12.md", "Markdown", 8, 0, 0, 0, 8
"/Users/longhui/code/study/github/front3-1/2020-11-13.md", "Markdown", 16, 0, 0, 1, 17
"/Users/longhui/code/study/github/front3-1/2020-11-14.md", "Markdown", 7, 0, 0, 0, 7
"/Users/longhui/code/study/github/front3-1/2020-11-15.md", "Markdown", 5, 0, 0, 0, 5
"/Users/longhui/code/study/github/front3-1/2020-11-16.md", "Markdown", 5, 0, 0, 0, 5
"/Users/longhui/code/study/github/front3-1/2020-11-17.md", "Markdown", 7, 0, 0, 0, 7
"/Users/longhui/code/study/github/front3-1/2020-11-18.md", "Markdown", 5, 0, 0, 0, 5
"/Users/longhui/code/study/github/front3-1/2020-11-19.md", "Markdown", 8, 0, 0, 0, 8
"/Users/longhui/code/study/github/front3-1/2020-11-20.md", "Markdown", 5, 0, 0, 0, 5
"/Users/longhui/code/study/github/front3-1/2020-11-21.md", "Markdown", 5, 0, 0, 0, 5
"/Users/longhui/code/study/github/front3-1/2020-11-22.md", "Markdown", 9, 0, 0, 0, 9
"/Users/longhui/code/study/github/front3-1/2020-11-23.md", "Markdown", 5, 0, 0, 0, 5
"/Users/longhui/code/study/github/front3-1/2020-11-24.md", "Markdown", 10, 0, 0, 0, 10
"/Users/longhui/code/study/github/front3-1/2020-11-25.md", "Markdown", 8, 0, 0, 0, 8
"/Users/longhui/code/study/github/front3-1/2020-11-26.md", "Markdown", 5, 0, 0, 0, 5
"/Users/longhui/code/study/github/front3-1/2020-11-27.md", "Markdown", 9, 0, 0, 0, 9
"/Users/longhui/code/study/github/front3-1/2020-11-28.md", "Markdown", 6, 0, 0, 0, 6
"/Users/longhui/code/study/github/front3-1/2020-11-29.md", "Markdown", 13, 0, 0, 0, 13
"/Users/longhui/code/study/github/front3-1/2020-11-30.md", "Markdown", 10, 0, 0, 0, 10
"/Users/longhui/code/study/github/front3-1/2020-12-01.md", "Markdown", 8, 0, 0, 0, 8
"/Users/longhui/code/study/github/front3-1/2020-12-02.md", "Markdown", 10, 0, 0, 0, 10
"/Users/longhui/code/study/github/front3-1/2020-12-03.md", "Markdown", 8, 0, 0, 0, 8
"/Users/longhui/code/study/github/front3-1/2020-12-04.md", "Markdown", 8, 0, 0, 0, 8
"/Users/longhui/code/study/github/front3-1/2020-12-05.md", "Markdown", 9, 0, 0, 0, 9
"/Users/longhui/code/study/github/front3-1/2020-12-06.md", "Markdown", 8, 0, 0, 0, 8
"/Users/longhui/code/study/github/front3-1/2020-12-07.md", "Markdown", 7, 0, 0, 0, 7
"/Users/longhui/code/study/github/front3-1/2020-12-08.md", "Markdown", 5, 0, 0, 1, 6
"/Users/longhui/code/study/github/front3-1/2020-12-09.md", "Markdown", 5, 0, 0, 0, 5
"/Users/longhui/code/study/github/front3-1/2020-12-10.md", "Markdown", 7, 0, 0, 0, 7
"/Users/longhui/code/study/github/front3-1/2020-12-11.md", "Markdown", 5, 0, 0, 1, 6
"/Users/longhui/code/study/github/front3-1/2020-12-12.md", "Markdown", 6, 0, 0, 0, 6
"/Users/longhui/code/study/github/front3-1/2020-12-13.md", "Markdown", 5, 0, 0, 0, 5
"/Users/longhui/code/study/github/front3-1/2020-12-14.md", "Markdown", 5, 0, 0, 0, 5
"/Users/longhui/code/study/github/front3-1/2020-12-15.md", "Markdown", 5, 0, 0, 0, 5
"/Users/longhui/code/study/github/front3-1/2020-12-16.md", "Markdown", 5, 0, 0, 0, 5
"/Users/longhui/code/study/github/front3-1/2020-12-17.md", "Markdown", 6, 0, 0, 0, 6
"/Users/longhui/code/study/github/front3-1/2020-12-18.md", "Markdown", 7, 0, 0, 0, 7
"/Users/longhui/code/study/github/front3-1/2020-12-19.md", "Markdown", 6, 0, 0, 0, 6
"/Users/longhui/code/study/github/front3-1/2020-12-20.md", "Markdown", 5, 0, 0, 0, 5
"/Users/longhui/code/study/github/front3-1/2020-12-21.md", "Markdown", 5, 0, 0, 0, 5
"/Users/longhui/code/study/github/front3-1/Node.md", "Markdown", 7, 0, 0, 0, 7
"/Users/longhui/code/study/github/front3-1/_config.yml", "YAML", 0, 1, 0, 0, 1
"/Users/longhui/code/study/github/front3-1/npm.md", "Markdown", 3, 0, 0, 0, 3
"/Users/longhui/code/study/github/front3-1/webpack.md", "Markdown", 4, 0, 0, 1, 5
"Total", "-", 4340, 1, 3, 62, 4406